NO ./path_to_the_north_texture 
SO ./path_to_the_south_texture
WE ./path_to_the_west_texture
EA ./path_to_the_east_texture

F 220,100,0
C 225,30,0

11111111111111111111111111111111111
10000000001100000000000000000000001
10110000011100000000000000000000001
10010000000000000000000000000000001
11111111101100000000000000011100001
10000000001100000000000000011101111
10000000000000000000000000000000001
100000000000000000000000S0000001001
10000000000000000000000000000000001
10000000000000000000000010000000001
10000000000000000000000010000001001
11111111111111111111111111111111111
