NO ./texture/stone_1024.xpm
SO ./texture/rock_256.xpm
WE ./texture/mur_mouse_512.xpm
EA ./texture/big.xpm
C ./texture/ceiling_512.xpm
F ./texture/ceiling_wood_512.xpm

111111111111111111111111111111111111111111111111111
100000000000100000011100000000000011111000000000011
11D1110011001000M0011100000000000011011001111111111
1000110011001001100001011001100000D001101
1000010011111001100001D11001100M001101101
11000000000000B11111110111111000001111001
1B000M0000000001011100000001111D111010001
1100000001011111D111000111011100011010001
110000000101100000011011100111000D0011011
1111D11111D1100000011011111111000110110111111111111
1B0000011101100110011D111000111D1100110000000000M01
1B00N00D000000011000000D000001101111110000M00000001
100000111000000110000001110001100000000110000000011
111111111111111111111111111111111111111111111111111
