NO ./texture/brick_256.xpm
SO ./texture/brick_256.xpm
WE ./texture/stone_1024.xpm
EA ./texture/rock_256.xpm
F ./texture/floor_512.xpm
C 0, 128, 255

111111111111111111111111111111111111111111111111111
100000000000100000011100000000000011111000000000011
11D111001100100000011100000000000011011001111111111
1000110011001001100001011001100000D001101
1000010011111001100001D110011000001101101
11000D00000000011111110111111000001111001
1000010000000001011100000001111D111010001
1110001111011111D111000111011100011010001
111011111101100000011011100111000D0011011
1110111111D1100000011011111111000110110111111111111
10000B111101100110011D111000111D1100110000000000001
10000N0D000000011000000D000001101111110000000000001
1M0000111000000110000001110001100000000110000000011
111111111111111111111111111111111111111111111111111
