NO ./texture/stone1.xpm
SO ./texture/stone1.xpm
WE ./texture/stone1.xpm
EA ./texture/stone1.xpm
C 150,150,151
F 150,145,142

111111111111111111111111111111111111111111111111111
100000000000100000011100000000000011111000000000011
11D111001100100000011100000000000011011001111111111
1000110011001001100001011001100000D001101
1000010011111001100001D110011000001101101
11000000000000B11111110111111000001111001
1B000M0000000001011100000001111D111010001
1100000001011111D111000111011100011010001
110000000101100000011011100111000D0011011
1111D11111D1100000011011111111000110110111111111111
1B0000011101100110011D111000111D1100110000000000001
1000N00D000000011000000D000001101111110000000000001
1M0000111000000110000001110001100000000110000000011
111111111111111111111111111111111111111111111111111
