NO ./texture/brick_256.xpm
SO ./texture/rock_256.xpm
WE ./texture/brick_256.xpm
EA ./texture/rock_256.xpm
F 139,37,35
C 9, 37, 135
111111111111111111111111111111111111111111111111111
100000000000100000011100000000000011111000000000011
110111001100100000011100000000000011011001011111011
100011001100100110000101100110000000011001000001111
100001001111100110000101100110000011011001111001111
110000000000000111111101111110000011110001100000001
110001000000000101110000000111101110100011110101011
111011111101111101110001110111000110100011110101011
111011111101100000011011100111000000110111111111011
111011111101100000011011111111000110110110000000011
100000111101100110011011100011101100110110000000011
100000111000000110000000000001101111110110000000011
100N00111000000110000001110001100000000110000000011
111111111111111111111111111111111111111111111111111
