NO ./texture/brick_256.xpm
SO ./texture/rock_256.xpm
WE ./texture/brick_256.xpm
EA ./texture/rock_256.xpm
F 39,37,35
C 39,37,35
111111111111111111111111111111111111111111111111111
100000000000100000011100000000000011111000000000011
110111001100100000011100000000000011011001011111011
100011001100100111111111111111111111111111000001111
1000010011111001                          100000001
1100000000000001                          100000001
1100010000000001                          100000001
1110111111011111                          100000001
1110111110000000                          100000001
11101111N0000001                          100000001
1000001110000000                          100000001
1000001110000001                          100000001
1000001110000001                          100000001
1111111111111111                          111111111
