NO ./texture/brick_256.xpm
SO ./texture/rock_256.xpm
WE ./texture/brick_256.xpm
EA ./texture/rock_256.xpm

C 51, 135 , 255
F 255, 255, 120

11111111111111111111111111111111111111111111111111111111111111
10010000100000000000000001000000000001000000000001000000000001
10001000000000000000000000000000000000000000000000000000000001
11000000000000000000000001111111111111111111111100000000000001
11100000000000000000000001                     100000000000001
10000000000000000000000000                     100000000000001
10000000000000000000000001                     100000000000001
100000000000000000000000011111011111111        111111111111111
100000000000000000000000000000000000001
10000000000000000000000000N000000000001
100000000000000000000000000000000000001
111101000000000000000000000000000000001
111111111111111111111111111111111111111