NO ./texture/test.xpm
SO ./texture/test.xpm
WE ./texture/test.xpm
EA ./texture/test.xpm

EA ./texture/rock_256.xpm


F 220,100,0
C 225,30,0


                 111111111
                 100000001
               11000000001
               10000011111
           1111000111
           1100000111
11111111111111011001
111000000000000000001
11000000111111111100111111111
1000000001    1011000S00111
1000000001    10110101001
1111111111    11111111111
