NO ./mandatory/texture/brick_256.xpm
SO ./mandatory/texture/rock_256.xpm
WE ./mandatory/texture/brick_256.xpm
EA ./mandatory/texture/rock_256.xpm

F 220,100,0
C 225,30,0

       111111111111111111111
   1   100000000000000000001
111N111000000001111111111111
1000000000000001
1000001110000001
1000001110000001
10000011111110001
1000001      1000000000011111111
1111111      111111111111
1111111    