F 65,103,64
NO ./mandatory/texture/brick_256.xpm
SO ./mandatory/texture/rock_256.xpm
EA ./mandatory/texture/rock_256.xpm
C 2,11,83
WE ./mandatory/texture/brick_256.xpm
111111111111
10000S000001
100000000001
111111111111