NO ./mandatory/texture/brick_256.xpm
SO ./mandatory/texture/rock_256.xpm
WE ./mandatory/texture/brick_256.xpm
EA ./mandatory/texture/rock_256.xpm

C 51, 135 , 255
F 255, 255, 120

11111111111111111111111111111111111111111111
10010000000100000000000100000000000100000001
10001000000000000000000000000000000000000001
11000000000111111111111111111111110000000001
111000000001                     10000000001
100000000001                     10000000001
100000000001                     10000000001
1000000000011111111111111        11111111111
1000000000000000000000001        00000000001
1000000000000000000000001        10000000001
1000000000000000000000001        10000000001
111100000000000N000000001        10000000001
1111000000000000000000001        10000000001
1111000000000000000000001        10000000001
1111111111111111111111111        11111111111