NO ./mandatory/texture/brick_256.xpm
SO ./mandatory/texture/rock_256.xpm
WE ./mandatory/texture/brick_256.xpm
EA ./mandatory/texture/rock_256.xpm
F 65,103,64
C 2,11,83
 11111
101011
110001
1  N01
111111
