NO       ./mandatory/texture/brick_256.xpm
SO     ./mandatory/texture/rock_256.xpm
WE ./mandatory/texture/brick_256.xpm
EA ./mandatory/texture/rock_256.xpm


F 220,110,0
C 225,30,0

 1
1011111111     11111111111
1000000001    100     001
1000000001    100     001
1001000001    10000011111
11110000011111100111
   1000000000000000111
   1000001000001010001
111000000111110000001
1100000011    111100111111111
1000000001    1011000S00111
1000000001    10110101001
1111111111    11111111111