NO ./bonus/texture/brick_256.xpm
SO ./bonus/texture/rock_256.xpm
WE ./bonus/texture/brick_256.xpm
EA ./bonus/texture/rock_256.xpm
F 65,103,64
C 2,11,83
         1111111111111111111111111
         1000000000110000000000001
    1    11011000001110000000000001
         100100000000000000000W001
111111111011000001110000000000001
10000000001100000111011111111111
1111011111111101110000001001
11110111111111011101010010001
1100000110101011100000010001
100000000000000110000010001
1000000000000000110101010001
1100000111010101111101111000111
11110111 1110101 101111010001
11111111 1111111 111111111111
