NO ./texture/brick_256.xpm
SO ./texture/rock_256.xpm
WE ./texture/brick_256.xpm
EA ./texture/rock_256.xpm
F 220, 100 ,0
C 225    ,30 , 0
111111
100101
101001
11E001
111111
