NO ./bonus/texture/brick_256.xpm
SO ./bonus/texture/rock_256.xpm
WE ./bonus/texture/brick_256.xpm
EA ./bonus/texture/rock_256.xpm
F 220, 100 ,0
C 225    ,30 , 0
111111
100101
101001
1100N1
111111
