NO ./bonus/texture/brick_256.xpm
SO ./bonus/texture/rock_256.xpm
WE ./bonus/texture/brick_256.xpm
EA ./bonus/texture/rock_256.xpm

C 51, 135 , 255
F 255, 255, 120

11111111111111111111111
11111111111111111111111
11111111111111111111111
11111111111111111111111
11111111111111111111111
11111111111111111111111
11111111111111111111111
111111111111N1111111111
11111111111111111111111
11111111111111111111111
11111111111111111111111
11111111111111111111111
11111111111111111111111
11111111111111111111111
11111111111111111111111