NO ./bonus/texture/brick_256.xpm
SO ./bonus/texture/rock_256.xpm
WE ./bonus/texture/brick_256.xpm
EA ./bonus/texture/rock_256.xpm

F 100,100,100
C 225,30,0

                    1
               11111011111
              100     001
1111111111    100     001
1001000001    10000011111
11110000011111100111
   1000000000000000111
   1000001000001010001
111000000111110000001
1100000011    111100111111111
1000000001    1011000S00111
1000000001    10110101001
1111111111    11111111111